NO ./resources/textures/wall2.xpm
SO ./resources/textures/wall2.xpm
WE ./resources/textures/wall2.xpm
EA ./resources/textures/wall2.xpm

D ./resources/textures/door1.xpm
F ./resources/textures/floor3.xpm
C ./resources/textures/sky1.xpm

H 255,160,0

        1111111111111111111111111
        1000000000110000000000001
        1011000001110000000000001
        1001000000000000000000001
111111111011000001110000000000001
100000000011000001110111121111111
11110111111111011100000020001
11110222222222022201010010001
110001111111110111000000100011111111111
100000000000000011000000100000000000001
100000000000000011010100000011111012101
11000001110101011111011110N01   1012101
11110111 11101010101111020001   1000001
11111111 11111110111111111111   1111111